


NO                       wall/n.xpm


F 40,   200,12
EA 			wall/e.xpm




SO wall/s.xpm
WE wall/w.xpm

C 40,100   ,   10

            1111  1111
            1N01  1001
            1111  1111


















