NO wall/n.xpm
NO wall/n.xpm
SO wall/s.xpm
WE wall/w.xpm
EA wall/e.xpm

F 100,100,100
C 100,100,100

11111111111
1222000000111
1000002000001
1000000000001
1000000000001
1000000000001
1000000000001
1000000000001
1000000000001   11111111111111
1000000000001   1111111111111
1000000000001
1000000000001
1000000000001
1000000000001
1000001111111
1110111
  101
  101
  1N1
  101
  111


