NO teapot.xpm
SO teapot.xpm
WE wall.xpm
EA teapot.xpm

F 200,50,0
C 40,100,10



    111111111111111111111111111111111111111111111111111111111111111111111111111111111111111111111111
    100000000000000000000000000000000000000000000000000000000000000000000000000000000000000000000001
    100000000000000000000000000000000000000000000000000000000000000000000000000000000000000000000001
    100000000000000000000000000000000000000000000000000000000000000000000000000000000000000000000001
    100000000000000000000000000000000000000000000000000000000000000000000000000000000000000000000001
    100000000000010000010000011000000001100000110011111111000000000000000000000000000000000000000001
    100000000000010000010000100100000001010001010010000000000000111110000000000000000000000000000001
    100000000000010000010001000010000001001010010010000000000001000000000000000000000000000000000001
    100000000000010000010001000010000001000100010011111111100001000000000000000000000000000000000001
    111111100000001000100001000010000001000000010010000000000001000000000000000000000000000000000001
          100000000000000101000001000010000001000000010010000000000001000000000000000000000000000001111111
          100000000000000010000000100100000001000000010010000000000001000000000000000000000000000000000001
          100000000000000010000000011000000001000000010010000000000000100000000000000000000000000000000001
          100000000000000010000000000000000001000000010011111111100000011111000000000000000000000000000001
          100000000000000010000000000000000000000000000000000000000000000000000000000000000000000000000001
          100000000000000000000000000000000000000000000000000000000000000000000000000000000000000001111111
    111111100000000000000000000000000000000000000000000000000000000000000000000000000000000000000001
    100000000000000000000000000000000000000000000000000000000000000000000000000000000000000000000001
    100000000000000000000000000000000000000000000000000000000000000000000000000000000000000000000001
    100000000000000000000000000000000000000000000000000000000000000000000000000000000000000000000001
    100000000000000000000000000000000000000000000000000000000000000000000000000000000000000000000001
    100000000000000000000000000000000000000000000000000000000000000000000000000000000000000000000001
    100000000000000000000000000000000000000000000000000000000000000000000000000000000000000000000001
    111111111111111111111111111111111111111111111111111111111111111111111111111111111111111111111111

