          NO             wall.xpm
SO teapot.xpm
WE wall.xpm
EA teapot.xpm

F 40,200,12
C 40,100,10

1111
1001
1111
