NO wall.xpm
SO teapot.xpm
WE wall.xpm
EA teapot.xpm

F 400,200,10
C 40,100,10

11111111111
1000000000111
1000000000001
1000000000001
1000000000001
1000001111111
1110111
  101
  101
  1N1
  101
  111


