NO wall/n.xpm
SO wall/s.xpm
WE wall/w.xpm
EA wall/e.xpm

F 40,200,12
C 40,100,10

1111
1NN1
1111
