NO wall/e.xpm
SO maps/invalid/___.cub
WE maps/invalid/___.cub
EA maps/invalid/___.cub

F 1,1,1
C 1,1,1

111111111
1000N0001
111111111
