NO wall/n.xpm
SO wall/n.xpm
WE wall/n.xpm
EA wall/n.xpm

F 20,20,20
C 200,200,200

11111
10001
10001
10001
10001
10001
11001
10001
10001
10001
10001
10001
11111













Q
