NO wall/n.xpm
SO wall/n.xpm
WE wall/n.xpm
EA wall/n.xpm

F 18,53,25
C 153,204,255

111111111111
1      S   11
1  0       1
111111111111
10000000001
111111111111
11         1
111111111111
